------------------------------------------------------------------------------------------------------------------------------------------------------
------------------------------------------------------------------------------------------------------------------------------------------------------
------------------------------------------------------------------------------------------------------------------------------------------------------
------------------------------------------------------------------------------------------------------------------------------------------------------
------------------------------------------------------------------------------------------------------------------------------------------------------
------------------------------------------------------------------------------------------------------------------------------------------------------
------------------------------------------------------------------------------------------------------------------------------------------------------
------------------------------------------------------------------------------------------------------------------------------------------------------
------------------------------------------------------------------------------------------------------------------------------------------------------
------------?--M-------h------------------b--------------------------M------------M---------h-------??---------h--------------------------------------
------------------------------------------------------------------------------------------------------------------------------------------------------
---------p----------------------------------------------------p---------------------------------p------------------------------------p---p------------
---------p-k--k--k----k--k-------------g----k-----k--------k--p-------------------k---g--k----kkp------------k-kg--k-k-g---k----k----p---p-----k------
GGGGG-G-GGGGGGGGGG-G-GG--GGGGGGGGGGGGG-G-GGGG-G-GGGGGG-G--GG-GGGGGGGGG-GGGGGGGGGGGGGGGGG-GGGG-GGGGGGGGGGGGGGGGGGGG-GGGGGGGGGGGGGGGGGGGG-GG--G--GGGGGGG
GGGGG-G-GGGGGGGGGG-G-GG--GGGGGGGGGGGGG-G-GGGG-G-GGGGGG-G--GG-GGGGGGGGG-GGGGGGGGGGGGGGGGG-GGGG-GGGGGGGGGGGGGGGGGGGG-GGGGGGGGGGGGGGGGGGGG-GG--G--GGGGGGG
